00111111
11100011
14230011
11103411
14113011
10104011
13053341
10004001
11111111